MqttSecureConnection	KEYWORD1
publish	KEYWORD2
debug	KEYWORD2
setupConnection	KEYWORD2
keepConnection	KEYWORD2
gracefulDisconnect	KEYWORD2
<nodemcu-mqtt-secure-connection.h>	KEYWORD1
WorkController	KEYWORD1
setInterval	KEYWORD2
isTimeToWork	KEYWORD2
<work-controller.h>	KEYWORD1
cleaner-sketch.h	KEYWORD1
CleanerSketch	KEYWORD1
begin	KEYWORD2
<cleaner-sketch.h>	KEYWORD1
NonBlockingCountdown	KEYWORD1
delay	KEYWORD2
countFinished	KEYWORD2
reset	KEYWORD2
<non-blocking-countdown.h>	KEYWORD1
